# **************************************************************************** #
#                                                                              #
#                                                         :::      ::::::::    #
#    infos.cub                                          :+:      :+:    :+:    #
#                                                     +:+ +:+         +:+      #
#    By: titorium <rarce@student.42.fr>             +#+  +:+       +#+         #
#                                                 +#+#+#+#+#+   +#+            #
#    Created: 2020/09/25 11:02:38 by titorium          #+#    #+#              #
#    Updated: 2020/10/23 11:49:10 by titorium         ###   ########.fr        #
#                                                                              #
# **************************************************************************** #

R   1920 1008
NO ./path_to_the_north_texture
SO ./path_to_the_south_texture
WE ./path_to_the_west_texture
EA ./path_to_the_east_texture

S ./path_to_the_sprite_texture
F 220,210,5
C 225,30,0

        1111111111111111111111111
        1000000000110000000000001
        1011000001110000002000001
        1001000000000000000000001
111111111011000001110000000000001
10000000001100000111011111111111111111111111
111101111111110111000000100000000000000000N01
11110111111111011101010010001111111111111111
11000000110101011100000010001
10002000000000001100000010001
10000000000000001101010010001
110000011101010111110111100111
11110111 1110101 101111010001
11111111 1111111 111111111111


